[1046]
cxSDatePopupClear = "Vazio"
cxSDatePopupToday = "Hoje"
cxSDatePopupCancel = "Cancelar"
cxSDatePopupNow = "Agora"
scxGridGroupByBoxCaption = "Para agrupar uma coluna, arraste-a até aqui!"
scxGridFilterIsEmpty = "<Sem Filtro>"
cxSFilterBoxAllCaption = "(TODOS)"
cxSFilterBoxCustomCaption = "(Personalizar...)"
cxSFilterBoxBlanksCaption = "(EM BRANCO)"
cxSFilterBoxNonBlanksCaption = "(PREENCHIDOS)"
cxSFilterOperatorNotEqual = "Diferente(s) de"
cxSFilterOperatorEqual = "Igual(is) à"
cxSFilterDialogRows = "Mostrar apenas linha(s):"
cxSFilterDialogOperationAnd = "[E]"
cxSFilterDialogOperationOr = "[OU]"
scxGridNoDataInfoText = "<Não há Dados para exibir>"
cxSFilterControlDialogCaption = "Gerador de Filtro"
cxSFilterControlDialogNewFile = "semnome.flt"
cxSFilterControlDialogOpenDialogCaption = "Abrir Filtro existente"
cxSFilterControlDialogSaveDialogCaption = "Salvar Filtro Ativo em arquivo"
cxSFilterControlDialogActionSaveCaption = "&Salvar como..."
cxSFilterControlDialogActionSaveHint = "Salvar como|Salvar o Filtro ativo com outro nome"
cxSFilterControlDialogActionOpenCaption = "&Abrir..."
cxSFilterControlDialogActionOpenHint = "Abrir|Abrir Filtro existente"
cxSFilterControlDialogActionApplyCaption = "&Aplicar"
cxSFilterControlDialogActionOkCaption = "OK"
cxSFilterControlDialogActionCancelCaption = "Cancelar"
cxSFilterControlDialogFileExt = "flt"
cxSFilterControlDialogFileFilter = "Filtros (*.flt)|*.flt"
cxSFilterBoolOperatorAnd = "[E]"
cxSFilterBoolOperatorOr = "[OU]"
cxSFilterBoolOperatorNotAnd = "[NEM TODOS]"
cxSFilterBoolOperatorNotOr = "[NENHUM]"
cxSFilterRootButtonCaption = "Filtro"
cxSFilterAddCondition = "Mais &Condição"
cxSFilterAddGroup = "Mais &Grupo"
cxSFilterRemoveRow = "&Remover Linha"
cxSFilterClearAll = "Limpar &Tudo"
cxSFilterFooterAddCondition = "pressione aqui para uma nova condição"
cxSFilterGroupCaption = "aplicar as seguintes condições"
cxSFilterRootGroupCaption = "<raiz>"
cxSFilterControlNullString = "<vazio>"
cxSFilterErrorBuilding = "Filtro não pode ser gerado"
cxSFilterDialogCaption = "Filtro Personalizado"
cxSFilterDialogInvalidValue = "Valor inválido"
cxSFilterDialogUse = "Usar"
cxSFilterDialogSingleCharacter = "representa uma letra/símbolo"
cxSFilterDialogCharactersSeries = "representa uma série de letras/símbolos"
cxSFilterOperatorEqual = "Igual"
cxSFilterOperatorNotEqual = "Diferente"
cxSFilterOperatorLess = "Menor que"
cxSFilterOperatorLessEqual = "Menor ou Igual"
cxSFilterOperatorGreater = "Maior que"
cxSFilterOperatorGreaterEqual = "Maior ou Igual"
cxSFilterOperatorLike = "Parece"
cxSFilterOperatorNotLike = "Não parece"
cxSFilterOperatorBetween = "Entre"
cxSFilterOperatorNotBetween = "Fora de"
cxSFilterOperatorInList = "Qualquer um"
cxSFilterOperatorNotInList = "Nenhum"
cxSFilterOperatorYesterday = "Ontem"
cxSFilterOperatorToday = "Hoje"
cxSFilterOperatorTomorrow = "Amanhã"
cxSFilterOperatorLast7Days = "Últimos 7 dias"
cxSFilterOperatorLastWeek = "Semana passada"
cxSFilterOperatorLast14Days = "Últimos 14 dias"
cxSFilterOperatorLastTwoWeeks = "Duas semanas atrás"
cxSFilterOperatorLast30Days = "Últimos 30 dias"
cxSFilterOperatorLastMonth = "Mês passado"
cxSFilterOperatorLastYear = "Ano passado"
cxSFilterOperatorPast = "Passado"
cxSFilterOperatorThisWeek = "Esta semana"
cxSFilterOperatorThisMonth = "Este mês"
cxSFilterOperatorThisYear = "Este ano"
cxSFilterOperatorNext7Days = "Is next 7 days"
cxSFilterOperatorNextWeek = "Is next week"
cxSFilterOperatorNext14Days = "Is next 14 days"
cxSFilterOperatorNextTwoWeeks = "Is next two weeks"
cxSFilterOperatorNext30Days = "Is next 30 days"
cxSFilterOperatorNextMonth = "Is next month"
cxSFilterOperatorNextYear = "Is next year"
cxSFilterOperatorFuture = "Is future"
cxSFilterAndCaption = "E"
cxSFilterOrCaption = "Ou"
cxSFilterNotCaption = "Não"
cxSFilterBlankCaption = "Vazio"
cxSFilterFromCaption = "de"
cxSFilterToCaption = "até"
cxSFilterOperatorIsNull = "Vazio"
cxSFilterOperatorIsNotNull = "Preenchido"
cxSFilterOperatorBeginsWith = "Inicia com"
cxSFilterOperatorDoesNotBeginWith = "Não inicia com"
cxSFilterOperatorEndsWith = "Acaba com"
cxSFilterOperatorDoesNotEndWith = "Não acaba com"
cxSFilterOperatorContains = "Contêm"
cxSFilterOperatorDoesNotContain = "Não contêm"
scxGridFilterCustomizeButtonCaption = "Personalizar..."

sdxExcelFilterFromValueText = "De"
sdxExcelFilterToValueText = "Para"
sdxExcelFilterTopNBottomNValueLabel = "Valor"
sdxExcelFilterTopNBottomNTypeLabel = "Tipo"
sdxExcelFilterCustomFilterAndOperatorLabel = "[E]"
sdxExcelFilterCustomFilterOrOperatorLabel = "[OU]"
sdxExcelFilterCustomFilterFirstConditionLabel = "First"
sdxExcelFilterCustomFilterSecondConditionLabel = "Second"
sdxExcelFilterValuesTabCaption = "Valores"
sdxExcelFilterDateFiltersTabCaption = "Filtro de Dada"
sdxExcelFilterTextFiltersTabCaption = "Filtro de Texto"
sdxExcelFilterTimeFiltersTabCaption = "Filtro de Hora"
sdxExcelFilterNumericFiltersTabCaption = "Filtro Numérico"
sdxExcelFilterSelectValueHintText = "Selecione um valor..."
sdxExcelFilterSelectDateHintText = "Selecione uma Data..."
sdxExcelFilterEnterValueHintText = "Informe um valor..."
sdxExcelFilterSpecificDatePeriodsConditionText = "Período"
sdxExcelFilterEqualsConditionText = "Igual"
sdxExcelFilterDoesNotEqualConditionText = "Diferente"
sdxExcelFilterBeginsWithConditionText = "Começa com"
sdxExcelFilterEndsWithConditionText = "Termina com"
sdxExcelFilterContainsConditionText = "Contêm"
sdxExcelFilterDoesNotContainConditionText = "Não contêm"
sdxExcelFilterIsBlankConditionText = "É vazio"
sdxExcelFilterIsNotBlankConditionText = "Não é vazio"
sdxExcelFilterBetweenConditionText = "Entre"
sdxExcelFilterGreaterThanConditionText = "Maior que"
sdxExcelFilterGreaterThanOrEqualToConditionText = "Maior ou igual"
sdxExcelFilterLessThanConditionText = "Menor que"
sdxExcelFilterLessEqualThanOrEqualToConditionText = "Menor ou igual"
sdxExcelFilterTopNConditionText = "Top N"
sdxExcelFilterBottomNConditionText = "Bottom N"
sdxExcelFilterAboveAverageConditionText = "Above Average"
sdxExcelFilterBelowAverageConditionText = "Below Average"
sdxExcelFilterBeforeConditionText = "Before"
sdxExcelFilterAfterConditionText = "After"
sdxExcelFilterYesterdayConditionText = "Yesterday"
sdxExcelFilterTodayConditionTypeText = "Today"
sdxExcelFilterTomorrowConditionText = "Tomorrow"
sdxExcelFilterLastWeekConditionText = "Last Week"
sdxExcelFilterThisWeekConditionText = "This Week"
sdxExcelFilterNextWeekConditionText = "Next Week"
sdxExcelFilterLastMonthConditionText = "Last Month"
sdxExcelFilterThisMonthConditionText = "This Month"
sdxExcelFilterNextMonthConditionText = "Next Month"
sdxExcelFilterLastYearConditionText = "Last Year"
sdxExcelFilterThisYearConditionText = "This Year"
sdxExcelFilterNextYearConditionText = "Next Year"
sdxExcelFilterCustomFilterConditionText = "Filtro Personalizado"
sdxExcelFilterPredefinedFiltersConditionText = "Filtro Predefinido"
sdxExcelFilterTopNBottomNItemsText = "Itens"
sdxExcelFilterTopNBottomNPercentText = "Percentual"
sdxFilterPopupWindowClearButtonCaption = "Limpar Filtro"
sdxFilterPopupWindowCloseButtonCaption = "Fechar"
sdxFilterPopupWindowCancelButtonCaption = "Cancelar"
sdxFilterPopupWindowOKButtonCaption = "OK"
